It's the middle of summer vacation and 100 degrees outside! You decide to jump in the pool to cool off, but just before you jump in, you drop your goggles and watch it sink straight to the bottom of the pool.

Pool
An Interactive Fiction by mloo19
Release 1 / Serial number 190215 / Inform 7 build 6M62 (I6/v6.33 lib 6/12N) SD

Deck
You are standing on the pool deck. It is surrounded by a metal fence with signs hanging on it. The deck is a half a foot above the pool and made of rocky concrete. Chairs are scattered accross the deck. The stairs leading down into the shallow end of the pool are below you.

On the fence is a net.

I beg your pardon?

>what do you do
That's not a verb I recognise.

>x net
A net with a long handle to scoop leaves and other objects out of the pool. It is locked onto the fence by a chain.

On the net is a chain (closed).

>take it
As you yank the net, the net doesn't budge. You need something to unlock the chain.

>d
Pool
The sparkling blue water cools you as you jump in. The deepest part of the pool is nine feet deep, and it is also where your goggles are. There is a purple inner tube floating on the surface of the pool.

You can see a purple inner tube (in which is a key) and a goggles here.

>x
What do you want to examine?

>curse
You can't see any such thing.

>x
What do you want to examine?

>x inner tube
A round purple floatie covered in flowers that you found in the pool.

In the purple inner tube is a key.

>take it
Now you have the purple inner tube.

>take key
You try to reach for it, but it is just out of reach. You need to get in the inner tube to reach the key.

>get in inner tube
You hop in and float along the surface of the water. You can feel your skin start to burn because of the sun and wish you had your goggles to go swimming.

Then you notice a golden sparkle out of the corner of your eye.

It's a key!

You take the key.

>out of inner tube
I only understood you as far as wanting to out.

>get out inner tube
I only understood you as far as wanting to get outside.

>exit inner tube
I only understood you as far as wanting to exit.

* * *

>d
Pool
You are standing in the shallow end of the pool, and the sparkling blue water cools you. The deepest part of the pool is nine feet deep, and it is also where your goggles are. The deck is above you.

You can see a purple inner tube here.

>enter purple inner tube
You hop into the purple inner tube. You can feel your skin start to burn and wish you had your goggles, so you could swim.

Out of the corner of your eye, you see a glint of metal.

It's a key!

>take key
Now you have the key.

>u
You would have to get out of the purple inner tube first.

>get out of purple inner tube
I only understood you as far as wanting to get outside.

* * *

>d
Pool
You are standing in the shallow end of the pool, and the sparkling blue water cools you. The deepest part of the pool is nine feet deep, and it is also where your goggles are. The deck is above you.

You can see a purple inner tube here.

>get in inner tube
You hop in and float along the surface of the water. You can feel your skin start to burn because of the sun and wish you had your goggles to go swimming.

Then you notice a golden sparkle out of the corner of your eye.

It's a key!

You take the key.

>take key
Now you have the key.

>get in purple inner tuve
I only understood you as far as wanting to get in the purple inner tube.

>get in purple inner tube
You hop in and float along the surface of the water. You can feel your skin start to burn because of the sun and wish you had your goggles to go swimming.

Then you notice a golden sparkle out of the corner of your eye.

It's a key!

>take key
You try to reach for it, but it is just out of reach. You need to get in the inner tube to reach the key.

* * *

>get in inner tube
You hop in and float along the surface of the water. You can feel your skin start to burn because of the sun and wish you had your goggles to go swimming.

Then you notice a golden sparkle out of the corner of your eye.

It's a key!

You take the key.

>u
Deck
You are standing on the pool deck. It is surrounded by a metal fence with signs hanging on it. The deck is a half a foot above the pool and made of rocky concrete.

On the fence is a net (on which is a chain (closed)).

>unlock chain
(with the key)
You unlock the chain.

>take net
Now you have the net.

>d
Pool
The sparkling blue water cools you as you jump in. The deepest part of the pool is nine feet deep, and it is also where your goggles are. There is a purple inner tube floating on the surface of the pool.

You can see a purple inner tube (empty) and a goggles here.

>take goggles
    *** You win! ***

Would you like to RESTART, RESTORE a saved game, QUIT or UNDO the last command?

* * *

>d
Pool
You are standing in the shallow end of the pool, and the sparkling blue water cools you. The deepest part of the pool is nine feet deep, and it is also where your goggles are. The deck is above you.

You can see a purple inner tube here.

>get in purple inner tube
You hop into the purple inner tube. You can feel your skin start to burn and wish you had your goggles, so you could swim.

Out of the corner of your eye, you see a glint of metal.

It's a key!

>get out of inner tube
I only understood you as far as wanting to get outside.

>get outside of inner tube
I only understood you as far as wanting to get outside.

* * *

>get in purple inner tube
You hop into the purple inner tube. You can feel your skin start to burn and wish you had your goggles, so you could swim.

Out of the corner of your eye, you see a glint of metal.

It's a key!

>get out of purple inner tube
You get out of the purple inner tube.

Pool
You are standing in the shallow end of the pool, and the sparkling blue water cools you. The deepest part of the pool is nine feet deep, and it is also where your goggles are. The deck is above you.

You can see a purple inner tube here.

* * *

>get in purple inner tube
You hop into the purple inner tube. You can feel your skin start to burn and wish you had your goggles, so you could swim.

Out of the corner of your eye, you see a glint of metal.

It's a key!

>take key
Now you have the key.

* * *

I beg your pardon?

* * *

>d
Pool
You are standing in the shallow end of the pool, and the sparkling blue water cools you. The deepest part of the pool is nine feet deep, and it is also where your goggles are. The deck is above you.

You can see a purple inner tube here.

>swim
That's not a verb I recognise.

>move
What do you want to move?

* * *

>d
Pool
You are standing in the shallow end of the pool, and the sparkling blue water cools you. The deepest part of the pool is nine feet deep, and it is also where your goggles are. The deck is above you.

You can see a purple inner tube here.

>take goggles
You try to dive down, but the chlorinated water burns your eyes, and you are forced to surface. You need something to scoop up the goggles.

>get in inner tube
You hop in and float along the surface of the water. You can feel your skin start to burn because of the sun and wish you had your goggles to go swimming.

Then you notice a golden sparkle out of the corner of your eye.

It's a key!

Pool (in the purple inner tube)
The sparkling blue water cools you as you jump in. The deepest part of the pool is nine feet deep, and it is also where your goggles are. There is a purple inner tube floating on the surface of the pool.

You can see a goggles here.

In the purple inner tube you can see a key.

>take key
Now you have the key.

* * *

>u
You would have to get out of the purple inner tube first.

>get out of inner tube
I only understood you as far as wanting to get outside.

* * *

>d
Pool
You are standing in the shallow end of the pool, and the sparkling blue water cools you. The deepest part of the pool is nine feet deep, and it is also where your goggles are. The deck is above you.

You can see a purple inner tube here.

>take key
Taken.

>u
Deck
You are standing on the pool deck. It is surrounded by a metal fence with signs hanging on it. The deck is a half a foot above the pool and made of rocky concrete.

On the fence is a net (on which is a chain (closed)).

>unlock chain with key
You unlock the chain.

>take net
Now you have the net.

>use net to take goggles
That's not a verb I recognise.

>take goggles
You can't see any such thing.

>d
Pool
The sparkling blue water cools you as you jump in. The deepest part of the pool is nine feet deep, and it is also where your goggles are. There is a purple inner tube floating on the surface of the pool.

You can see a purple inner tube (empty) and a goggles here.

>take goggles
Taken.

    *** You win! ***

Would you like to RESTART, RESTORE a saved game, QUIT or UNDO the last command?

* * *

>take fork
Now you have the fork.

* * *

>take key
You can't see any such thing.

* * *

>x fence
A metal fence with signs including information about the rules of the pool. There is also a net chained to the fence, which is used to scoop things out of the pool.

On the fence is a net.

>x net
A net with a long handle to scoop leaves and other objects out of the pool. It is locked onto the fence by a chain.

>take net
As you yank the net, the net doesn't budge. You need something to unlock the chain.

>d
Pool
The sparkling blue water cools you as you jump in. The deepest part of the pool is nine feet deep, and it is also where your goggles are. There is a purple inner tube floating on the surface of the pool.

You can see a purple inner tube (empty) and a goggles here.

>get in inner tube
You hop in and float along the surface of the water. You can feel your skin start to burn because of the sun and wish you had your goggles to go swimming.

Then you notice a golden sparkle out of the corner of your eye.

It's a key!

>take key
You can't see any such thing.

* * *

>take net
As you yank the net, the net doesn't budge. You need something to unlock the chain.

>unlock chain
You can't see any such thing.

* * *

>x net
A net with a long handle to scoop leaves and other objects out of the pool. It is locked onto the fence by a chain.

>x chain
A metal lock holding the net on the fence.

>d
Pool
The sparkling blue water cools you as you jump in. The deepest part of the pool is nine feet deep, and it is also where your goggles are. There is a purple inner tube floating on the surface of the pool.

You can see a purple inner tube (in which is a key) and a goggles here.

>x purple inner tube
A round purple floatie covered in flowers that you found in the pool.

In the purple inner tube is a key.

>get in inner tube
You hop in and float along the surface of the water. You can feel your skin start to burn because of the sun and wish you had your goggles to go swimming.

Then you notice a golden sparkle out of the corner of your eye.

It's a key!

>take key
Taken.

* * *

>u
Deck
You are standing on the pool deck. It is surrounded by a metal fence with signs hanging on it. The deck is a half a foot above the pool and made of rocky concrete.

On the fence is a net (on which is a chain (closed)).

>unlock chain with key
That doesn't seem to fit the lock.

* * *

>x fork
A metal utensil with three sharp tines that you eat food with.

* * *

>x net
A net with a long handle to scoop leaves and other objects out of the pool. It is locked onto the fence by a chain.

* * *

>take net
As you yank the net, the net doesn't budge. You need something to unlock the chain.

>x deck
You can't see any such thing.

>x chairs
You can't see any such thing.

>x signs
You can't see any such thing.

>read signs
You can't see any such thing.

>d
Pool
You are standing in the shallow end of the pool, and the sparkling blue water cools you. The deepest part of the pool is nine feet deep, and it is also where your goggles are. The deck is above you.

You can see a purple inner tube here.

>x tube
A round purple floatie covered in flowers that you found in the pool.

>x pool
You can't see any such thing.

>take tube
Now you have the purple inner tube.

>d
You can't go that way.

>enter tube
You can only get into something free-standing.

>get in tube
You can only get into something free-standing.

>get in purple inner tube
You can only get into something free-standing.

>ride purple inner tube
That's not a verb I recognise.

>get in inner tube
You can only get into something free-standing.

>get in inner tube
You can only get into something free-standing.

>get on inner tube
You can only get into something free-standing.

>enter inner tube
You can only get into something free-standing.

>drop inner tube
Dropped.

>get in inner tube
You hop into the purple inner tube. You can feel your skin start to burn and wish you had your goggles, so you could swim.

Out of the corner of your eye, you see a glint of metal resting on the inner tube.

It's a key!

>take key
Now you have the key.

* * *

>u
You would have to get out of the purple inner tube first.

>get out of inner tube
You get out of the purple inner tube.

Pool
You are standing in the shallow end of the pool, and the sparkling blue water cools you. The deepest part of the pool is nine feet deep, and it is also where your goggles are. The deck is above you.

You can see a purple inner tube (empty) here.

>u
Deck
You are standing on the pool deck. It is surrounded by a metal fence with signs hanging on it. The deck is a half a foot above the pool and made of rocky concrete. Chairs are scattered accross the deck.

On the fence is a net.

>get net
As you yank the net, the net doesn't budge. You need something to unlock the chain.

>unlcok chain with key
That's not a verb I recognise.

>oops unlock
Sorry, that can't be corrected.

>unlock chain with key
You unlock the chain.

* * *

>take net
Now you have the net.

>get goggles
You can't see any such thing.

>d
Pool
You are standing in the shallow end of the pool, and the sparkling blue water cools you. The deepest part of the pool is nine feet deep, and it is also where your goggles are. The deck is above you.

You can see a purple inner tube (empty) here.

>take goggles
    *** You win! ***

Would you like to RESTART, RESTORE a saved game, QUIT or UNDO the last command?

* * *

>x chain
A metal lock holding the net on the fence.

>unlock chain
(with the fence)
(first taking the fence)
That's hardly portable.

>d
Pool
The sparkling blue water cools you as you jump in. The deepest part of the pool is nine feet deep, and it is also where your goggles are. There is a purple inner tube floating on the surface of the pool.

You can see a purple inner tube (in which is a key) and a goggles here.

>take key
You try to reach for it, but it is just out of reach. You need to get in the inner tube to reach the key.

>get in inner tube
You hop in and float along the surface of the water. You can feel your skin start to burn because of the sun and wish you had your goggles to go swimming.

Then you notice a golden sparkle out of the corner of your eye.

It's a key!

>take key
You try to reach for it, but it is just out of reach. You need to get in the inner tube to reach the key.